8,0,0,0,0,0,0,0,0,0,0,0,0,0,0,0,0,0,0,0,0,7
9,8,0,0,0,0,0,0,0,0,0,0,0,0,0,0,0,0,0,0,7,9
9,9,0,0,0,0,0,0,0,0,0,0,0,0,0,0,0,0,0,0,9,9
9,9,0,0,0,0,0,0,0,0,0,0,0,0,0,0,0,0,0,0,9,9
9,9,1,0,0,0,0,0,0,0,0,0,0,0,0,0,0,0,0,0,9,9
9,6,6,5,0,0,0,0,0,0,0,0,0,0,0,0,0,0,0,0,9,9
9,9,10,0,0,0,0,11,11,11,0,0,0,0,11,0,0,0,11,11,9,9
9,9,8,0,2,0,0,7,6,8,0,2,0,7,6,8,0,2,7,6,9,9
9,9,9,6,6,6,6,9,9,9,6,6,6,9,9,9,6,6,9,9,9,9
9,9,9,9,9,9,9,9,9,9,9,9,9,9,9,9,9,9,9,9,9,9
9,9,9,9,9,9,9,9,9,9,9,9,9,9,9,9,9,9,9,9,9,9